◽◽◽◽◽◽◽◽◽◽◽◽◽◽◽◽◽◽◽◽◽◽◽◽◽◽◽◽◽◽◽◽◽◽◽◽◽◽◽◽◽◽◽◽◽◽◽◽◽◽◽◽◽◽◽◽◽◽◽◽◽◽◽◽◽◽◽◽◽◽◽◽◽◽◽◽◽◽◽◽◽◽◽◽◽◽◽◽◽◽◽◽◽◽◽◽◽◽◽◽◽◽◽◽◽◽◽◽◽◽◽◽◽◽◽◽◽◽◽◽◽◽◽◽◽◽◽◽◽◽◽◽◽◽◽◽◽◽◽◽◽◽◽◽◽◽◽◽◽◽◽◽◽◽◽◽◽◽◽◽◽◽◽◽◽◽◽◽◽◽◽◽◽◽◽◽◽◽◽◽◽◽
◽◾◾◾◾◾◽◾◾◾◽◾◾◾◽◾◾◾◽◾◾◾◾◾◾◾◾◾◾◾◾◾◾◾◾◾◾◾◾◾◾◾◾◾◾◾◾◾◾◾◾◾◽◾◾◽◾◾◽◾◾◾◾◾◾◾◾◾◾◾◾◾◾◾◾◾◾◾◾◾◾◾◾◽◾◽◾◾◾◾◾◾◾◾◾◾◾◾◾◾◽◾◾◾◽◾◾◾◾◾◾◽◾◽◾◽◾◽◾◽◾◽◾◽◾◽◾◽◾◾◾◾◽◾◽◾◾◾◽◾◾◽◽◾◾◾◽◾◾◾◾◾◾◾◾◾◾◾◾◾◾◽◽◽◽◾◽◾◾◾◾◾◾◾◾◾◾◾◾◾◾◽
◽◾◽◾◽◽◾◾◽◽◾◽◾◽◾◽◾◽◾◾◽◽◾◽◾◽◾◽◾◽◾◽◾◽◾◽◾◽◾◽◾◽◾◽◽◽◾◽◽◽◽◽◾◽◾◽◽◾◾◾◽◽◾◽◾◽◾◽◾◽◾◽◾◽◾◽◾◽◾◽◾◽◾◾◾◾◾◽◾◽◾◽◾◽◽◾◽◽◾◽◾◽◾◽◾◾◽◽◾◽◾◾◾◾◾◾◾◾◾◾◾◾◾◾◾◾◾◾◽◾◽◾◾◾◾◾◽◽◾◽◾◾◾◽◾◽◾◽◾◽◽◽◾◽◾◽◾◽◾◽◾◾◽◽◾◾◾◾◽◽◾◽◽◾◽◾◽◽◾◽◾◽
◽◾◾◽◾◽◾◽◾◾◾◾◾◾◾◾◾◾◾◽◾◾◾◾◽◾◾◽◾◾◽◾◾◾◽◽◽◾◾◾◽◾◾◾◾◽◾◾◾◾◾◾◾◾◾◾◾◾◽◾◾◾◽◾◾◾◽◾◾◾◽◾◾◽◾◽◾◾◽◽◾◾◽◽◾◽◾◾◽◽◾◾◽◾◾◾◽◾◾◾◾◾◾◾◾◽◾◾◽◾◾◽◽◽◽◽◾◽◾◽◾◽◾◽◾◽◾◽◾◽◾◽◽◾◽◾◾◽◾◾◽◾◽◾◾◾◾◾◾◾◾◾◽◾◽◾◽◽◽◽◽◾◾◾◾◽◾◽◽◽◽◾◾◽◽◽◾◾◽◾◽◽
◽◽◾◾◾◾◾◾◾◽◽◾◽◾◽◾◽◾◽◾◽◽◾◽◾◽◽◾◾◽◾◽◽◽◾◽◾◽◾◽◾◾◽◾◽◽◾◽◾◽◾◽◾◽◾◽◽◾◽◾◽◾◾◽◾◽◽◽◾◽◾◽◾◽◾◽◾◽◾◾◽◾◽◽◾◾◽◾◾◾◽◾◽◽◾◽◾◽◾◽◾◽◾◽◾◾◾◽◽◽◾◾◾◾◾◾◽◾◽◽◽◾◾◾◽◾◾◾◾◾◾◽◾◾◾◽◽◾◽◾◽◾◾◽◾◽◾◽◾◽◾◽◾◾◾◾◾◽◾◽◾◾◽◾◽◾◽◾◽◽◽◾◽◾◽◾◾◽◾◾◾◽
◽◾◾◽◽◾◽◽◽◾◾◽◽◾◾◽◾◾◽◾◾◽◾◾◾◾◾◽◾◾◾◾◾◾◾◾◾◾◽◽◽◾◽◾◾◾◽◾◾◾◽◾◾◽◾◾◽◾◾◽◾◽◾◾◽◾◽◾◾◾◾◽◾◽◾◽◾◾◾◽◾◾◾◾◽◾◾◽◾◽◾◾◾◾◽◽◾◽◾◾◽◾◾◾◽◾◽◾◽◽◽◾◽◾◽◾◾◾◾◽◾◽◾◽◾◽◾◽◾◽◽◽◽◾◽◾◽◾◾◾◽◾◽◾◾◾◽◾◽◾◽◽◾◽◽◾◽◾◾◾◽◽◾◽◾◾◾◾◾◽◾◾◾◾◾◽◾◾◾◽◾◽
◽◽◾◽◾◾◾◾◾◾◽◾◾◽◾◾◽◾◾◾◽◾◽◽◾◽◾◽◾◽◾◽◾◽◾◽◾◽◽◽◾◽◾◾◽◾◾◽◾◽◾◽◾◽◽◾◽◽◾◾◾◾◽◽◾◾◾◽◾◽◾◾◽◾◾◽◾◽◾◾◽◽◾◽◾◾◽◾◾◽◽◾◽◾◽◾◾◾◾◽◽◽◾◽◾◾◾◾◾◽◾◾◽◽◽◾◽◽◾◾◾◾◽◽◾◾◽◾◽◾◾◽◾◾◽◾◾◽◽◾◽◾◽◾◽◽◽◾◾◾◽◾◾◾◾◽◾◾◽◽◾◾◾◾◽◾◽◾◽◾◽◾◽◽◾◾◾◽◾◽◾◽
◽◽◾◾◽◾◽◾◽◾◾◾◽◾◽◾◽◾◽◾◾◾◾◾◽◾◾◾◽◾◾◽◾◽◾◾◽◾◽◾◾◽◽◾◾◽◽◾◽◾◾◽◾◾◾◽◾◾◾◽◽◾◽◾◽◾◽◾◽◾◽◾◾◽◾◾◽◾◾◽◾◾◽◾◽◾◾◽◽◾◽◾◾◽◾◾◽◾◽◾◽◾◾◽◽◾◽◽◾◾◽◾◾◾◾◽◾◾◽◾◽◽◾◾◾◽◾◾◾◽◾◾◽◾◽◽◾◾◽◾◽◾◽◾◾◾◾◾◽◽◾◽◾◽◽◾◽◾◽◾◾◽◾◽◾◾◾◽◾◾◽◾◽◾◽◾◽◾◽◾◽◽
◽◾◾◽◾◾◽◾◽◾◽◾◾◾◾◽◽◾◾◽◾◽◾◽◾◽◾◽◽◽◾◽◾◾◽◾◾◾◾◾◽◾◽◾◽◾◾◾◾◽◾◾◾◽◾◾◽◽◾◾◾◽◾◾◾◾◾◾◾◾◾◽◾◽◾◽◾◽◾◾◾◽◾◾◽◾◽◾◾◾◾◽◽◾◽◽◾◾◾◾◾◽◽◾◾◽◾◾◽◾◾◽◾◽◾◾◾◽◾◽◾◽◾◽◽◾◾◽◾◾◽◾◽◾◾◽◾◽◽◾◾◾◾◾◽◽◽◽◾◽◾◽◾◽◽◾◾◾◾◾◽◾◽◾◽◾◽◽◾◽◽◾◾◾◽◽◾◾◽◾◾◽
◽◾◽◽◾◽◾◾◾◽◽◽◽◽◽◾◾◽◾◾◽◽◽◾◾◾◽◾◽◾◽◾◾◽◾◾◽◾◽◾◾◾◾◽◾◽◾◽◽◾◽◾◽◽◾◽◾◽◾◽◾◾◾◽◽◽◽◽◾◽◾◾◽◾◾◾◾◽◾◽◾◽◾◽◾◽◽◽◾◽◾◽◾◾◾◾◽◾◽◾◽◾◾◽◾◾◾◽◾◽◽◾◽◾◾◽◽◾◾◾◾◾◾◾◽◾◽◾◽◾◽◾◽◾◽◾◾◾◾◾◽◽◽◾◾◾◾◾◾◾◾◾◾◾◾◾◽◾◽◾◾◾◾◾◾◾◾◾◾◾◾◾◽◾◾◾◾◽◾◽◾◽
◽◾◾◾◽◾◾◽◾◾◽◾◾◾◾◾◽◾◽◽◾◽◾◾◽◽◽◾◾◾◾◽◽◾◽◾◽◽◾◽◾◽◾◾◾◾◾◾◾◾◾◽◾◾◽◾◾◾◾◾◽◽◾◾◾◾◾◾◽◾◽◽◾◽◽◽◾◽◾◾◽◾◾◾◾◾◽◾◾◽◾◾◾◽◽◾◽◾◽◽◾◾◽◾◾◽◽◾◾◾◾◾◾◽◽◾◽◾◽◽◽◾◽◾◾◾◾◾◾◽◾◾◽◾◾◾◽◾◽◾◾◾◾◽◾◽◾◽◾◽◾◽◽◽◾◽◾◾◽◾◽◽◾◽◾◽◾◽◾◽◾◽◾◽◾◽◾◾◾◾◾◽
◽◾◽◾◽◾◽◾◽◾◾◾◽◽◽◽◽◾◽◾◾◾◾◽◾◾◾◾◽◾◽◾◾◾◽◾◾◾◾◾◽◾◽◽◽◽◽◾◽◽◽◾◽◾◾◽◾◽◾◽◽◾◾◽◽◾◽◾◾◾◾◾◾◾◾◾◽◾◽◾◾◾◽◾◽◽◾◽◾◾◽◽◾◽◾◽◾◾◾◽◾◽◾◽◾◾◾◾◽◾◽◽◽◾◽◾◽◾◽◾◾◽◾◾◽◾◽◾◽◾◽◾◽◾◽◽◾◽◾◽◾◽◽◾◾◾◽◽◾◽◾◾◾◾◽◽◽◾◽◾◽◾◽◾◽◽◽◾◽◽◾◾◾◾◽◾◽◾◽◾◽◽
◽◾◾◽◾◾◾◾◽◾◽◾◾◾◾◾◾◾◾◾◽◽◽◾◽◾◽◽◾◽◾◾◽◽◾◾◽◽◾◽◾◾◾◾◾◾◽◾◾◾◾◾◾◾◽◽◽◾◽◽◾◽◾◾◽◽◾◽◽◽◾◽◾◽◾◽◽◾◽◾◽◽◾◽◾◽◾◽◾◽◾◽◽◾◾◽◽◾◽◾◾◽◾◾◾◽◽◽◾◽◾◾◾◾◾◾◾◾◾◾◽◾◽◽◾◽◾◽◾◾◾◾◾◾◾◾◾◾◾◾◽◾◽◽◾◽◾◾◽◾◾◽◽◽◾◽◽◽◽◽◾◾◾◾◾◽◾◾◾◾◽◾◽◾◾◾◽◾◾◽◽◽
◽◾◽◽◽◾◽◾◽◾◾◽◾◽◽◽◽◾◽◾◾◾◾◾◾◾◾◾◾◾◾◽◾◽◾◽◽◽◾◾◾◽◾◽◾◽◾◾◽◾◽◾◽◽◾◽◾◾◾◾◾◾◽◾◾◾◾◾◾◾◽◽◾◾◽◽◾◾◾◾◾◾◾◾◾◾◾◾◾◾◾◾◽◾◽◾◾◽◾◽◾◾◽◽◾◾◾◾◾◾◾◽◽◾◽◾◽◾◽◾◾◾◾◾◾◾◾◾◾◽◾◽◾◽◾◽◾◽◽◾◾◾◾◾◽◾◾◽◾◽◾◾◾◾◾◾◽◾◽◾◾◽◾◽◾◾◾◽◽◾◾◽◾◾◽◾◾◽◽◾◽◽
◽◾◾◽◾◾◽◾◾◽◾◽◾◾◾◾◾◽◾◾◽◽◽◾◽◽◾◽◾◽◾◾◾◾◽◾◽◾◾◽◾◾◽◾◽◾◾◽◾◾◽◾◾◾◾◾◽◾◽◾◽◾◽◾◽◽◾◽◾◽◽◾◾◽◾◾◾◽◾◽◾◽◾◽◽◾◽◽◾◽◽◾◾◾◾◾◽◽◾◽◾◽◾◽◾◽◽◽◽◾◽◾◾◾◽◾◽◽◾◽◾◽◾◽◽◾◽◽◾◽◾◾◽◾◾◾◽◽◾◽◾◽◾◽◾◾◽◾◾◾◽◽◾◽◽◽◾◾◾◾◽◾◾◽◾◽◾◾◾◽◾◾◽◾◾◽◾◾◾◾◾◽
◽◾◽◾◽◾◾◽◽◾◾◽◾◽◽◾◽◾◾◽◾◾◾◾◾◾◽◽◾◾◽◾◽◾◾◾◾◽◾◾◽◾◾◾◾◽◾◾◽◾◽◾◽◾◽◾◾◾◽◾◽◽◾◾◾◽◾◾◽◾◾◽◽◾◽◽◽◾◾◾◽◾◾◾◾◽◽◾◾◾◾◽◽◾◽◾◾◾◾◾◾◾◾◾◾◾◾◾◾◽◾◾◽◽◽◾◾◾◾◾◽◽◾◾◽◾◽◾◽◽◾◽◾◽◽◽◾◾◾◾◽◾◽◾◽◾◾◽◾◽◾◾◽◾◾◾◾◽◽◽◾◽◽◾◾◽◾◽◽◾◾◽◽◽◽◾◾◽◾◽◾◽
◽◾◽◾◾◾◽◽◾◽◽◾◽◾◽◾◾◽◽◽◾◽◾◽◾◽◽◾◽◾◽◾◽◽◾◽◾◽◾◽◾◾◽◽◽◾◾◽◾◽◾◾◾◽◾◽◽◽◾◽◾◽◽◽◽◾◾◽◾◾◽◾◾◾◾◾◾◽◾◽◾◽◾◽◾◾◾◽◾◽◾◾◽◽◽◾◽◾◽◾◽◾◽◾◽◾◽◾◽◾◽◽◾◾◾◽◽◾◽◾◾◾◽◾◽◾◾◾◽◾◽◾◾◾◾◾◽◽◾◽◽◾◾◾◽◾◽◾◾◾◾◽◾◽◽◾◽◽◾◾◾◾◾◽◾◽◽◾◾◽◽◾◽◾◽◽◽◾◽◾◽◽
◽◾◽◾◽◾◾◾◾◾◾◾◾◾◾◽◾◾◾◾◽◾◾◾◽◾◾◾◽◾◽◾◾◾◽◾◾◾◽◾◽◾◾◾◾◽◾◾◾◾◽◾◽◾◾◾◾◾◾◾◾◾◾◾◾◽◾◾◽◾◾◾◽◽◾◽◾◾◽◽◾◽◾◾◽◾◽◽◾◽◽◽◾◾◾◽◾◾◾◽◾◾◽◾◾◽◾◾◾◾◾◾◽◾◽◾◾◽◾◽◾◽◽◾◽◾◽◾◾◾◾◾◽◾◽◾◾◾◾◾◾◾◽◾◾◾◾◾◽◽◾◾◾◾◾◾◾◾◾◽◾◽◾◾◽◾◾◾◽◾◾◾◾◾◾◾◾◾◾◾◾◽
◽◾◾◽◾◾◽◾◽◾◽◾◽◾◽◾◽◾◽◾◽◽◽◾◽◾◽◽◾◽◾◽◽◾◾◽◽◽◽◾◾◽◾◽◾◾◽◽◾◽◾◾◽◾◽◽◽◽◾◽◾◽◾◽◾◾◽◾◾◾◽◾◾◾◽◽◾◽◾◾◾◾◾◽◾◾◽◾◾◾◾◾◾◽◽◾◽◾◽◾◽◾◽◾◽◾◽◽◾◽◽◾◽◾◾◾◽◾◾◾◽◾◾◽◾◾◽◾◽◽◾◽◾◽◾◽◾◽◾◽◾◽◽◽◾◽◾◽◾◾◾◽◽◾◽◽◾◽◾◾◽◾◾◽◾◽◽◾◾◾◽◽◾◽◽◾◽◽◽◽◽◽
◽◽◾◾◽◾◽◾◾◽◾◾◾◽◾◾◾◽◾◾◾◾◽◾◾◾◾◾◾◾◾◾◾◽◾◾◾◾◾◾◽◾◽◾◽◽◾◽◾◾◽◾◾◾◾◾◾◾◽◾◽◾◾◾◽◾◾◽◾◽◾◾◽◾◾◾◽◽◽◾◽◽◾◽◾◽◽◽◾◽◾◽◾◾◾◾◽◾◾◾◽◽◾◾◾◾◾◽◽◾◾◽◾◾◽◾◾◾◽◽◾◽◾◽◾◽◾◾◾◽◾◾◾◾◾◽◾◽◾◾◽◾◽◾◾◾◽◾◽◽◾◾◽◾◾◽◾◾◽◾◾◽◾◾◾◾◾◾◽◾◾◾◽◾◽◾◾◾◾◾◾◽
◽◾◾◽◾◾◾◽◾◾◽◾◽◾◽◾◽◾◾◽◾◽◽◾◽◽◾◽◾◽◾◽◾◾◽◾◽◽◽◾◾◾◾◾◾◾◾◾◽◽◾◽◾◽◾◽◽◾◾◾◾◽◾◽◽◾◽◾◾◾◽◾◾◽◾◽◽◽◾◾◽◽◾◾◽◾◽◾◾◾◽◽◾◽◾◽◽◾◽◾◾◾◽◾◽◽◽◾◽◾◽◽◾◽◽◾◽◽◾◾◾◾◾◾◽◾◽◽◾◽◾◽◾◽◾◾◽◽◾◽◾◾◽◽◾◽◾◾◾◽◽◾◽◾◽◾◾◽◽◾◽◾◾◽◾◽◾◽◽◾◽◾◽◾◾◾◽◽◾◽◾◽
◽◽◾◾◽◾◽◽◾◽◾◾◾◾◾◾◾◽◾◾◽◾◾◾◾◾◽◾◾◾◽◾◾◽◾◾◾◾◾◽◾◽◾◽◾◽◾◽◽◾◾◽◾◾◽◾◾◾◽◾◽◽◾◾◾◽◾◽◽◾◾◽◾◽◾◾◽◾◽◾◾◾◽◾◾◾◽◾◽◾◾◾◽◽◾◾◾◽◾◾◽◽◾◾◾◾◾◾◾◾◾◾◾◽◾◽◾◾◾◽◾◽◽◾◾◾◾◾◽◾◽◾◽◽◽◾◾◾◽◽◾◽◾◽◾◽◾◽◾◾◾◽◾◽◾◽◾◾◾◽◽◾◽◾◾◽◾◾◾◽◽◾◽◽◾◽◽◽◾◾◽◽
◽◾◾◽◾◾◽◾◾◾◽◾◽◽◽◾◽◾◽◽◾◽◾◽◾◽◾◽◾◽◾◽◽◾◽◾◽◽◾◽◾◽◾◾◽◽◾◾◾◾◽◽◾◽◾◾◽◾◾◽◾◾◾◽◾◾◾◾◽◽◾◾◽◾◽◽◾◾◽◽◾◽◾◾◽◽◾◽◾◾◽◾◾◾◽◾◽◾◽◽◽◾◾◽◾◽◾◽◾◽◾◽◾◾◾◽◾◽◽◾◽◽◾◽◾◽◽◽◾◾◾◾◾◽◾◾◽◽◾◾◾◾◾◾◽◾◽◽◾◽◽◽◾◽◾◽◾◽◾◽◾◽◾◽◾◽◾◽◾◾◾◽◾◾◾◾◽◾◾◽◾◽
◽◾◽◾◽◽◾◾◽◽◾◾◾◾◾◽◾◾◾◾◾◾◽◾◾◽◾◽◾◾◾◾◾◾◾◽◾◽◾◾◽◾◾◽◾◾◽◾◽◾◾◾◽◾◽◽◾◾◽◾◾◽◾◾◽◾◽◾◾◾◽◾◾◾◾◾◾◽◾◾◾◾◽◾◾◾◾◾◽◾◾◽◾◽◾◾◾◾◾◾◾◽◾◾◽◾◾◾◽◾◾◽◾◽◽◾◾◾◾◾◽◾◾◾◽◾◾◾◾◽◽◽◽◾◽◽◽◾◽◾◽◾◽◾◽◾◾◾◾◾◾◾◾◾◾◾◽◽◾◾◾◾◾◾◽◾◾◾◽◾◽◾◽◾◽◾◾◽◾◾◾◽
◽◾◽◾◾◽◾◽◾◾◽◾◽◽◾◾◽◾◽◾◽◾◾◽◾◾◾◾◽◾◽◾◽◽◽◽◾◽◽◽◾◽◽◾◾◽◾◾◽◾◽◾◾◾◾◾◽◾◾◽◽◾◽◾◾◽◾◽◾◽◽◾◽◾◽◾◽◽◽◽◾◽◾◽◾◽◽◽◾◾◽◾◽◾◽◾◽◾◽◾◽◾◾◽◽◽◾◽◾◽◾◾◽◾◽◾◽◽◽◽◾◽◾◽◾◾◽◽◾◾◾◾◾◾◾◾◾◾◾◾◾◽◾◽◾◽◾◽◽◾◽◾◽◽◽◾◾◾◽◾◽◾◽◾◾◽◽◾◽◽◾◾◽◽◾◾◽◾◽◽◽◽
◽◽◾◽◾◾◾◾◾◽◾◾◾◾◽◾◾◾◾◽◾◽◽◾◾◽◾◽◾◽◽◾◾◾◾◾◾◾◾◾◾◾◾◾◽◾◽◾◾◽◾◽◽◽◾◽◽◽◾◾◾◾◾◽◾◾◾◾◽◾◾◾◾◽◾◽◾◽◾◽◾◽◾◾◾◾◾◾◽◾◾◾◾◾◾◽◽◾◾◽◾◾◽◾◽◾◽◾◾◽◽◾◾◾◾◾◾◾◾◾◾◾◾◾◾◽◾◽◽◽◾◽◾◽◾◽◾◽◾◽◾◾◾◽◾◾◾◾◾◽◽◾◾◾◾◽◽◽◾◾◽◾◾◽◽◾◾◽◾◾◽◾◾◾◽◾◾◾◾◾◾◽
◽◾◾◾◾◽◽◽◽◾◽◾◽◾◾◽◾◽◾◾◾◾◾◽◾◽◾◾◾◾◾◽◾◽◾◽◾◽◾◽◾◽◾◽◾◾◾◽◾◾◾◾◾◾◽◾◽◾◾◽◾◽◾◾◽◽◾◽◾◾◽◽◾◾◾◾◾◾◾◾◽◽◽◾◽◾◽◾◽◾◽◾◽◽◾◽◾◽◾◾◽◾◽◾◾◾◾◾◽◾◽◽◾◽◾◽◾◽◾◽◾◽◾◽◾◾◾◾◾◾◽◾◽◾◾◾◽◽◾◽◽◾◽◾◾◽◽◽◾◽◾◽◽◽◾◾◾◽◾◽◾◽◽◾◾◽◾◾◽◾◾◽◾◽◾◽◽◽◾◽◾◽
◽◽◾◽◾◾◾◾◽◾◾◾◾◽◾◽◾◽◾◽◾◽◾◾◽◾◾◽◾◽◾◾◽◾◾◽◾◽◾◽◾◾◽◾◽◾◽◾◽◾◽◾◽◽◾◾◾◽◾◾◽◾◾◽◾◾◽◾◽◽◽◽◾◽◽◾◽◾◽◾◽◽◽◾◽◾◾◽◾◾◾◽◾◾◽◾◾◾◽◽◾◽◾◾◽◽◾◽◾◾◾◽◾◽◾◾◽◾◾◾◽◾◾◽◾◽◾◽◾◽◾◾◾◽◽◽◾◾◽◾◾◽◽◽◾◾◾◾◽◾◾◽◾◽◽◽◽◾◽◾◾◾◾◾◽◾◾◽◾◽◾◾◾◾◾◾◾◾◽◽◽◽
◽◾◾◾◽◾◽◾◽◾◽◾◽◾◽◾◽◽◾◾◽◾◾◽◾◽◾◾◽◾◾◽◾◽◾◾◽◽◾◽◾◽◾◾◾◾◾◾◾◽◽◽◾◾◽◾◽◽◽◾◽◽◾◾◽◾◽◾◽◾◽◾◽◾◽◽◾◽◾◽◾◽◾◽◾◽◽◾◽◽◽◽◾◽◾◽◾◽◾◽◾◽◽◾◽◾◽◽◾◽◽◽◾◽◾◽◾◽◾◽◾◽◾◽◾◾◽◾◽◾◽◽◾◽◾◽◾◽◽◾◽◾◽◽◾◽◽◽◾◽◾◾◾◾◾◾◾◾◾◾◽◽◽◽◾◽◾◾◾◾◾◽◽◾◽◾◽◽◾◽◾◽
◽◽◾◽◾◾◾◽◾◾◽◾◾◾◾◾◾◾◽◾◾◽◽◾◾◽◾◽◾◽◾◾◾◾◽◾◾◾◽◽◾◾◾◽◽◽◽◽◽◾◽◾◽◾◾◾◾◽◽◾◾◾◽◾◾◾◾◾◾◾◾◾◾◾◾◾◾◾◾◾◾◾◾◾◾◾◾◾◾◾◾◾◾◾◾◾◾◾◾◾◾◾◾◾◾◾◾◾◾◾◾◾◽◽◾◾◾◾◽◽◾◾◾◾◽◾◾◾◾◾◾◾◾◾◾◾◾◾◾◾◾◾◾◾◾◾◾◾◾◾◾◽◽◽◽◽◽◽◽◾◾◾◾◾◾◾◾◽◾◽◾◾◽◽◽◾◾◾◾◾◾◽
◽◾◾◽◾◽◾◾◽◽◾◾◽◽◾◽◾◽◽◽◾◾◾◾◽◾◾◾◾◽◾◽◾◽◽◽◾◽◾◾◾◽◾◾◾◾◾◾◾◾◾◾◾◾◽◽◾◾◾◽◾◽◽◽◾◽◾◽◾◽◾◽◾◽◾◽◽◾◽◽◾◽◾◽◽◾◽◾◽◾◽◾◽◾◽◾◽◾◽◽◾◽◽◾◽◽◾◽◾◽◾◽◾◾◾◽◾◽◾◾◾◽◾◽◾◾◽◽◾◽◾◽◾◽◾◽◾◽◾◽◾◽◾◽◾◽◾◽◾◽◾◾◾◾◾◾◾◾◾◽◾◽◾◽◽◾◽◾◾◾◽◾◾◾◾◽◾◽◾◽◾◽
◽◽◽◽◽◽◽◽◽◽◽◽◽◽◽◽◽◽◽◽◽◽◽◽◽◽◽◽◽◽◽◽◽◽◽◽◽◽◽◽◽◽◽◽◽◽◽◽◽◽◽◽◽◽◽◽◽◽◽◽◽◽◽◽◽◽◽◽◽◽◽◽◽◽◽◽◽◽◽◽◽◽◽◽◽◽◽◽◽◽◽◽◽◽◽◽◽◽◽◽◽◽◽◽◽◽◽◽◽◽◽◽◽◽◽◽◽◽◽◽◽◽◽◽◽◽◽◽◽◽◽◽◽◽◽◽◽◽◽◽◽◽◽◽◽◽◽◽◽◽◽◽◽◽◽◽◽◽◽◽◽◽◽◽◽◽◽◽◽◽◽◽◽◽◽◽◽◽◽◽◽◽
